вулиця 40 років комсомолу 	> вулиця Антіна Синявського
Провулок 40 років комсомолу 	> провулок Синявського
вулиця 55 років ВЛКСМ 	> вулиця Пластівська
вулиця 60-річчя Жовтня 	> вулиця Енергетиків
Площа 80-річчя Дніпропетровської області 	> площа Козацька
вулиця 80-річчя Дніпропетровщини 	> вулиця Олександра Красносельського
Сквер 80-річчя Дніпропетровської області 	> Сквер Сосновий
вулиця XIX партз'їзду 	> вулиця Івана Гонти
вулиця XXII партз’їзду 	> вулиця Вознесенська
вулиця XXV партз'їзду 	> вулиця Князя Костянтина Острозького
вулиця Аверіна 	> вулиця Курінна
вулиця Аврори 	> вулиця Трифона Гладченка
вулиця Арсеничева 	> вулиця Олександра Рейнгарда
вулиця Артема 	> вулиця Січових Стрільців
вулиця Бабушкіна 	> вулиця Романа Шухевича
Провулок Бабушкіна 	> провулок В'язовий
Район Бабушкінський 	> Район Шевченківський
вулиця Баглія 	> вулиця Брацлавська
Провулок Бакуніна 	> провулок Ігренський
вулиця Балка колгоспна 	> вулиця Балка мальовнича
вулиця Барбюса 	> вулиця Євгена Сердюкова
вулиця Баумана 	> вулиця Павла Нірінберга
вулиця Бєлінського 	> вулиця Ізмаїла Срезневського
вулиця Бібікова 	> вулиця Павла Бута
вулиця Білостоцького 	> вулиця Любарського
Провулок Білостоцького 	> провулок Любарського
Провулок Більшовицький 	> вулиця Холодноярська
вулиця Благоєва 	> вулиця Сергія Подолинського
вулиця Блюхера 	> вулиця Романа Мстиславовича
вулиця Боженка 	> вулиця Хортицька
вулиця Большунова 	> вулиця Данила Сахненка
вулиця Бонч-Бруєвича 	> вулиця Дмитра Байди-Вишневецького
вулиця Братів Каменських 	> вулиця Зернова
вулиця Братів Ковальчуків 	> вулиця Байдаківська
вулиця Братів Міллер 	> вулиця Леоніда Жебуньова
Провулок Братів Трофімових 	> провулок Діївський
вулиця Братів Трофімових 	> вулиця Велика Діївська
вулиця Будьонного 	> вулиця Данила Галицького
вулиця Булата 	> вулиця Люблянська
вулиця Булигіна 	> вулиця Івана Езау
вулиця Валявки 	> вулиця Данила Апостола
вулиця Варейкіса 	> вулиця Джузеппе Гарібальді
вулиця Вахрушева 	> вулиця Василя Сидоренка
вулиця Винокурова 	> вулиця Дніпросталівська
вулиця Власенка 	> вулиця Гулака-Артемовського
вулиця Войкова 	> вулиця Краківська
вулиця Войцеховича 	> вулиця Миколи Руденка
Проїзд Войцеховський 	> Проїзд Швидкісний
вулиця Володарського 	> вулиця Олександра Кониського
вулиця Володимира Ошка 	> вулиця Солідарності
вулиця Воровського 	> вулиця Дмитра Багалія
Проспект Воронцова 	> Проспект Мануйлівський
Ж/м Воронцовський 	> Ж/м Мануйлівський
вулиця Ворошилова 	> вулиця Сергія Єфремова
вулиця Ворошиловград-ська 	> вулиця Пшенична
Проспект Газети "Правда" 	> Проспект Слобожанський
вулиця Галана 	> вулиця Івана Піддубного
вулиця Галана 	> вулиця Празької весни
вулиця Галковського 	> вулиця Сарматська
вулиця Гайдара 	> вулиця Дмитра Марковича
вулиця Генерала Грушевого 	> вулиця Гетьмана Петра Дорошенка
вулиця Героїв Громадянської війни 	> вулиця Марії Лисиченко
вулиця Героїв Сталінграда 	> Проспект Богдана Хмельницького
вулиця Годовикова 	> вулиця Братиславська
вулиця Гопнер 	> вулиця Магдебурзького права
Площа Горького 	> площа Половицька
вулиця Горького 	> вулиця Княгині Ольги
вулиця Губанова 	> вулиця Лубенська
вулиця Гудкова 	> вулиця Яна Гуса
Площа Дем'яна Бєдного 	> площа Успенська
вулиця Дзержинського 	> вулиця Коханівська
Площа Дзержинського 	> площа Новокодацька
вулиця Дзержинського 	> вулиця Володимира Вернадського
Провулок Дзержинського 	> провулок Зоряний
Провулок Дибенка 	> провулок Привабливий
вулиця Дибенка 	> вулиця Василя Кука
вулиця Дибенка 	> вулиця Хотинська
вулиця Димитрова 	> вулиця Хизовська
вулиця Димитрова 	> вулиця Михайла Драгоманова
вулиця Дмитра Донського 	> вулиця Дмитра Донцова
вулиця Дундича 	> вулиця Хорватська
вулиця Енгельса 	> вулиця Афанасьєва-Чужбинського
Провулок Єрмака 	> провулок Кленовий
вулиця Желваківського 	> вулиця Полонської-Василенко
вулиця Жовтенят 	> вулиця Фортечна
вулиця Жовтнева 	> вулиця Золотоосіння
вулиця Жовтнева 	> вулиця Марії Приймаченко
Площа Жовтнева 	> площа Соборна
Провулок Жовтневий 	> провулок Золотоосінній
Район Жовтневий 	> Район Соборний
Сквер Жовтневий 	> Сквер Івана Старова
вулиця Жуковського 	> вулиця Василя Жуковського
вулиця Замарайкіна 	> вулиця Корсунська
вулиця Замполіта Бєляєва 	> вулиця Бєляєва
вулиця Захаренка 	> вулиця Глухівська
вулиця Івана Зінукова 	> вулиця Портова
вулиця Івана Сусаніна 	> вулиця Майстрів
Провулок Івана Сусаніна 	> провулок Майстрів
Проспект Ілліча 	> Проспект Пилипа Орлика
Провулок Ілліча 	> провулок Орлика
Затока ім. Кірова 	> затока Затишна
Сквер ім. Леніна 	> Сквер Героїв
Парк ім. Ленінського комсомола 	> парк Зелений Гай
Парк ім. Воронцова 	> парк Сагайдак
Парк ім. Калініна 	> парк Пам’яті та Примирення
Парк ім. Кірова 	> парк Кирилівка
вулиця Іскри 	> вулиця Піскова
Провулок Калініна 	> провулок Січовий
Узвіз Калініна 	> узвіз Ярмарковий
вулиця Калінінградська 	> вулиця Трофима Романченка
вулиця Каляєва 	> вулиця Симиренківська
вулиця Кантемирівська 	> вулиця Євгена Маланюка
вулиця Карла Лібкнехта 	> вулиця Михайла Грушевського
Проспект Карла Маркса 	> Проспект Дмитра Яворницького
вулиця Карпуші 	> вулиця Єлагінська
вулиця Квірінга 	> вулиця Бельгійська
вулиця КІМа 	> вулиця Мелитопольська
вулиця Кірінаківська 	> вулиця Деревлянська
Тупик Кірова 	> вулиця Мальвова
Проспект Кірова 	> Проспект Олександра Поля
Провулок Кірова 	> провулок Назарія Яремчука
вулиця Кірова 	> вулиця Старий шлях
Стадіон Кірова 	> стадіон Петра Лайка
вулиця Кіровоградська 	> вулиця Інгульська
Провулок Кіровоградський 	> провулок Інгульський
Район Кіровський 	> Район Центральний
вулиця Клари Цеткін 	> вулиця Володимира Моссаковського
вулиця Клочка 	> вулиця Данила Заболотного
Ж/м Клочко 	> Ж/м Калиновський
вулиця Колгоспна 	> вулиця Фермерська
Провулок Колгоспний 	> провулок Лоцманів Казанців
вулиця Коллонтай 	> вулиця Ганни Барвінок
вулиця Комбідівська 	> вулиця Василя Хитя
вулиця Комінтерну 	> вулиця Яхненківська
вулиця Комісара Крилова 	> вулиця Олександра Оцупа
вулиця Комісарівська 	> вулиця Гайдамацька
Провулок Комісарівський 	> провулок Гайдамацький
вулиця Комітетська 	> вулиця Василя Капніста
вулиця Комсомольська 	> вулиця Айдарівська
вулиця Комсомольська 	> вулиця Старокозацька
Острів Комсомольський 	> острів Монастирський
Провулок Комсомольський 	> вулиця Дібровська
Ж/м Комунар 	> Ж/м Покровський
Ст.метро Комунарівська 	> Ст.метро Покровська
вулиця Комунарівська 	> вулиця Юрія Кондратюка
вулиця Копилова 	> вулиця Бориса Познанського
Провулок Копилова 	> провулок Бориса Познанського
вулиця Корнійчука 	> вулиця Бориса Мозолевського
вулиця Косарева 	> вулиця Сіверянська
вулиця Косіора 	> вулиця Петра Калнишевського
вулиця Котовського 	> вулиця Тернівська
вулиця Котовського 	> вулиця Івана Труби
вулиця Кочкіна 	> вулиця Євгена Вирового
Провулок Красіна 	> провулок Косинський
вулиця Красіна 	> вулиця Криштофа Косинського
Район Красногвардійській 	> Район Чечелівський
вулиця Краснозаводська 	> вулиця Академіка Белелюбського
вулиця Краснопресненська 	> вулиця Самійла Величка
Тупик Краснопреснен-ський 	> тупик Самійлівський
вулиця Красночечелівська 	> вулиця Олександра Чернікова
вулиця Крейсера "Аврора" 	> вулиця Олександра Галича
вулиця Крошки 	> вулиця Михайла Комарова
вулиця Крупської 	> вулиця Баллінська
вулиця Кузнецова 	> вулиця Тетяни Пати
вулиця Кузнецова 	> вулиця Опанаса Ковпака
вулиця Куйбишева 	> вулиця Володимира Винниченка
вулиця Курочкіна 	> вулиця Cемена Бардадима
Провулок Лалаянца 	> провулок Скляренка
вулиця Лалаянца 	> вулиця Семена Скляренка
вулиця Лафарга 	> вулиця Генерала Радієвського
вулиця Лебедя 	> вулиця Федора Сторубля
вулиця Леніна 	> вулиця Генерала Волівача
вулиця Леніна 	> вулиця Степани Бандери
вулиця Ленінградська 	> вулиця Князя Ярослава Мудрого
вулиця Леніногорська 	> вулиця Миколи Хвильового
Район Ленінський 	> Район Новокодацький
вулиця Леоніда Брежнєва 	> вулиця Братства тарасівців
вулиця Лепсе 	> вулиця Миколи Кузьменка
вулиця Логаша 	> вулиця Івана Пулюя
Провулок Логаша 	> провулок Івана Пулюя
вулиця Лукашенка 	> вулиця Андрія Штогаренка
вулиця Луначарського 	> вулиця Василя Стуса
Провулок Людмили Мокієвської 	> провулок Крушельницької
Провулок Людмили Сталь 	> вулиця Шодуарівська
Сквер М. О. Щолокова 	> Сквер Юрія Переможця
вулиця Малишева 	> вулиця Василя Тютюнника
Провулок Малишева 	> провулок Тютюнника
Тупик Малишева 	> тупик Тютюнника
вулиця Манкевича 	> вулиця Галі Мазуренко
вулиця Мануїльського 	> вулиця Михайла Максимовича
вулиця Маршала Жукова 	> вулиця Героїв Дніпра
Провулок Маршала Жукова 	> провулок Героїчний
вулиця Матлахова 	> вулиця Кості Гордієнка
вулиця Менжинського 	> вулиця Миколи Сумцова
вулиця Меренкова 	> вулиця Павла Полуботка
Площа Миколи Островського 	> площа Старомостова
вулиця Мироненка 	> вулиця Олени Ган
вулиця Миронова 	> вулиця Європейська
вулиця Митрофана Андреєва 	> вулиця Петра Сокальського
вулиця Мініна 	> вулиця Менахем Мендл Шнеєрсона
Парк Міський молодіжний парк дозвілля та відпочинку ім.В.І.Леніна 	> парк Міський молодіжний дозвілля і відпочинку «Новокодацький»
вулиця Модестова 	> вулиця Миколи Садовського
вулиця МОПРа 	> вулиця Григорія Омельченка
вулиця Моріса Тореза 	> вулиця Березанівська
вулиця Московська 	> Володимира Мономаха
вулиця Набережна В.І.Леніна 	> вулиця Січеславська Набережна
вулиця Набережна Чудновського 	> вулиця Набережна Старосамарська
вулиця Новодзержинська 	> вулиця Козирева
вулиця Новофрунзенська 	> вулиця Юркевича
вулиця Ногинська 	> вулиця Володимира Івасюка
Провулок Ногинський 	> провулок Яворовий
вулиця Орджонікідзе 	> вулиця Петра Бикова
вулиця Островського 	> вулиця Миколи Зерова
Провулок Островського 	> провулок Миколи Зерова
вулиця Павла Корчагіна 	> вулиця Миколи Куліша
вулиця Пархоменка 	> вулиця Григорія Граб’янки
вулиця Пелагеї Поляхової 	> вулиця Лебединська
вулиця Пеліна 	> вулиця Катерини Мессарош
вулиця Перекопської перемоги 	> вулиця Олександри Риндовської
вулиця Петра Моїсеєнка 	> вулиця Василя Курбаса
вулиця Петра Сиротиніна 	> вулиця Лавандова
вулиця Петровського 	> вулиця Андрія Сахарова
Проспект Петровського 	> Проспект Івана Мазепи
Площа Петровського 	> площа Вокзальна
вулиця Піонерська 	> вулиця Омеляновича-Павленка
вулиця Піонерська 	> вулиця Олени Пчілки
вулиця Піонерська 	> вулиця Бортницька
Провулок Піонерський 	> провулок Михайла Дідевича
Провулок Піонерський 	> провулок Марти Головіної
Провулок Піонерський 	> провулок Скаутський
вулиця Плеханова 	> вулиця Князя Володимира Великого
вулиця Повстання 	> вулиця Мужності
вулиця Погребняка 	> вулиця Полігонна
вулиця Подвойського 	> вулиця Осипа Бодянського
вулиця Покровського 	> вулиця Покровська
вулиця Постишева 	> вулиця Олександра Серебрякова
Провулок Пролетарської перемоги 	> провулок Каразінський
вулиця Пролетарської перемоги 	> вулиця Василя Каразіна
вулиця Профінтерну 	> вулиця Володимира Хрінникова
вулиця П'ятирічки 	> вулиця Шляхівська
вулиця Радгоспна 	> вулиця Василя Сухомлинського
вулиця Радгоспна 	> вулиця Нестора Махна
вулиця Радянська 	> вулиця Славна
Провулок Радянський 	> провулок Феодосія Макаревського
вулиця Радянської Армії 	> вулиця Волонтерська
вулиця Революційна 	> вулиця Полковника Горленка
вулиця Рогальова 	> узвіз Крутогірний
вулиця Рози Люксембург 	> вулиця Марії Заньковецької
вулиця Руднєва 	> вулиця Івана Вишенського
вулиця Сафонова 	> вулиця Новгород-Сіверська
вулиця Свердлова 	> вулиця Володимира Антоновича
Провулок Свердлова 	> вулиця Казкова
вулиця Сергія Лазо 	> вулиця Кулишівська
вулиця Сериківська 	> вулиця Тиверська
Провулок Сериківський 	> провулок Тиверський
вулиця Сєрова 	> вулиця Андрія Фабра
Провулок Сиворонова 	> провулок Веселковий
вулиця Сировця 	> вулиця Якова Острянина
вулиця Сільрадська 	> вулиця Лірницька
вулиця Соціалістична 	> вулиця Павла Чубинського
вулиця Союзна 	> вулиця Старобазарна
вулиця Стаханівців 	> вулиця Івана Сокульського
вулиця Суханова 	> вулиця Станіслава Оріховського
вулиця Таманська 	> вулиця Василя Симоненка
вулиця Тевосяна 	> вулиця Роксолани
вулиця Тельмана 	> вулиця Ріжкова
вулиця Тельмана 	> вулиця Ігоря Сікорського
Провулок Тельмана 	> провулок Івана Сохача
вулиця Тихона Бондарева 	> вулиця Карпатська
вулиця Ткаченка 	> вулиця Вадима Сідура
Узвіз Тольятті 	> узвіз Кодацький
вулиця Ульяновська 	> вулиця Михайла Лояна
Провулок Урицького 	> провулок Євгена Коновальця
Узвіз Урицького 	> узвіз Струківський
Провулок Фабріціуса 	> провулок Івана Купали
вулиця Фабріціуса 	> вулиця Ярославни
Провулок Фрунзе 	> вулиця Заборинська
вулиця Фрунзе 	> вулиця Сержанта Андрющенка
вулиця Фрунзе 	> вулиця Василя Чапленка
Ж/м Фрунзенський-1 	> Ж/м Ломівський
Ж/м Фрунзенський-2 	> Ж/м Кам’янський
вулиця Фурманова 	> вулиця Героїв Крут
вулиця Фурманова 	> вулиця Олени Теліги
вулиця Фучика 	> вулиця Івана Акінфієва
вулиця Хуліана Грімау 	> вулиця Віктора Мерзленка
Провулок Цхакая 	> провулок Улюблений
вулиця Цхакая 	> вулиця Василя Біднова
Провулок Цюрупинський 	> провулок Весняних конвалій
вулиця Чапаєва 	> вулиця Олександра Потебні
вулиця Чапаєва 	> вулиця Болбочана
вулиця Чекістів 	> вулиця Переможна
Площа Червона 	> площа Троїцька
вулиця Червона 	> вулиця Троїцька
вулиця Червоних бійців 	> вулиця Кобзарська
вулиця Червоноармійська 	> вулиця Просвітянська
вулиця Червоноармійська 	> вулиця Футбольна
Провулок Червоноармійський 	> провулок Червонокалиновий
вулиця Червонобогатир-ська 	> вулиця Богатирська
вулиця Червоногірська 	> вулиця Святогірська
вулиця Червоного козацтва 	> вулиця Терещенківська
вулиця Червонопартизан-ська 	> вулиця Василя Макуха
вулиця Червоноповстан-ська балка 	> вулиця Довга балка
Провулок Червонопролетар-ський 	> провулок Порічковий
вулиця Червонофлотська 	> вулиця Петра Григоренка
вулиця Чередниченка 	> вулиця Михайла Вербицького
вулиця Чичеріна 	> вулиця Надії Алексєєнко
вулиця Чкалова 	> вулиця Святослава Хороброго
вулиця Чубаря 	> вулиця Володимира Сосюри
вулиця Шаумяна 	> вулиця Нагірна
вулиця Шелгунова 	> вулиця Максима Дія
вулиця Шпіндяка 	> вулиця Симона Петлюри
вулиця Щаденка 	> вулиця Марії Грінченко
вулиця Щербицького 	> вулиця Олени Блавацької
вулиця Щорса 	> вулиця Данили Будницького
вулиця Щорса 	> вулиця Костомарівська
вулиця Юних ленінців 	> вулиця Козака Мамая
вулиця Якіра 	> вулиця Івана Сулими
Провулок Якіра 	> провулок Сулимівський
вулиця Яшина 	> вулиця Володимира Самодриги
